000000000000222
000000000000222
000000000000222
000000000000000
000000000000000
000001100010000
000000100010000
010000000010000
000000100011111
000000100000000
000000000000000
000000000000000
000000000000000
000000001000000
001000000011111
000000000010000
000000000010000
222000000000000
222000000000000
222000000000000