000000000000222
000000000000222
000000000010222
000000000000000
000000000000000
000001100000000
000000000000000
010000000000000
000000000000000
000000000000000
000000000000000
000000000000000
000000000000000
000000001000000
001000000000000
000000000000000
000000000000000
222000000000000
222000000000000
222000000000000